~~~~~~~~~~~~~~~~~~~~~~~~~~~~~~~~~~~~~
1111111111
---l--l---
---l--l---
11-l--l-11
11-l--l-11
11SSSSSS11
1111111111
1111111111
~~~~~~~~~~~~~~~~~~~~~~~~~~~~~~~~~~~~~
1111111111
-l-l-l-l--
-l-l-l-l--
-l-l-l-l--
a--------A
1SSSSSSSS1
1111111111
1111111111
~~~~~~~~~~~~~~~~~~~~~~~~~~~~~~~~~~~~~
1111111111
-l-l-l-l-l
-l-l-l-l-l
-l-l-l-l-l
----------
SSSSSSSSSS
1111111111
1111111111
~~~~~~~~~~~~~~~~~~~~~~~~~~~~~~~~~~~~~
1111111111
----------
--------A1
11-------1
-----P----
111-111111
11B1111P11
11111B1111
~~~~~~~~~~~~~~~~~~~~~~~~~~~~~~~~~~~~~
1111111111
----------
----L111--
----l-----
----l-----
1a------11
111---1111
1111111111
~~~~~~~~~~~~~~~~~~~~~~~~~~~~~~~~~~~~~
1111111111
----------
1111------
-------A11
A11-------
1111------
1111111111
1111111111
~~~~~~~~~~~~~~~~~~~~~~~~~~~~~~~~~~~~~
1111111111
----------
------P---
1a----111-
111-------
1111----11
111111-111
1111111111
~~~~~~~~~~~~~~~~~~~~~~~~~~~~~~~~~~~~~
1111111111
11111--11-
--11------
1--1------
1-------1-
1a-----111
1111111111
1111111111
~~~~~~~~~~~~~~~~~~~~~~~~~~~~~~~~~~~~~
1111111111
----------
----11L---
------l---
--1111l---
----A1l---
1111111111
1111111111
~~~~~~~~~~~~~~~~~~~~~~~~~~~~~~~~~~~~~
1111111111
----------
-------L11
111----l--
--a----l--
111----l--
1111111111
1111111111
~~~~~~~~~~~~~~~~~~~~~~~~~~~~~~~~~~~~~
