~~~~~~~~~~~~~~~~~~~~~~~~~~~~~~~~~~~~~
----------
-----11---
----------
11------11
11------11
11SSSS-S11
111111S111
1111111111
~~~~~~~~~~~~~~~~~~~~~~~~~~~~~~~~~~~~~
----------
----------
----------
----------
1-------11
11a----S11
111111S111
1111111111
~~~~~~~~~~~~~~~~~~~~~~~~~~~~~~~~~~~~~
111--111--
----11--11
----111L--
-------l--
-------l--
11SSSS-S11
111111S1B1
111--11111
~~~~~~~~~~~~~~~~~~~~~~~~~~~~~~~~~~~~~
---1111---
-----11---
----------
11--------
-11a------
1111------
1--111--11
1111111111
~~~~~~~~~~~~~~~~~~~~~~~~~~~~~~~~~~~~~
1111------
111-------
------11L-
111a--11l-
------11l-
-----111l-
111111-111
1111111111
~~~~~~~~~~~~~~~~~~~~~~~~~~~~~~~~~~~~~
----------
-11111111-
-1------1-
-111LL111-
-P--ll--P-
-111LL111-
-1--ll--1-
1111111111
~~~~~~~~~~~~~~~~~~~~~~~~~~~~~~~~~~~~~
11111-----
111----L11
-11----l--
--1----l--
------1111
11-----111
111-------
1111111111
~~~~~~~~~~~~~~~~~~~~~~~~~~~~~~~~~~~~~
111--A1111
----------
--111-----
----------
111-------
--1-----11
11--11S111
1111111111
~~~~~~~~~~~~~~~~~~~~~~~~~~~~~~~~~~~~~
----------
----------
--------11
--------11
---11-----
--111-----
111111SSS1
1----11111
~~~~~~~~~~~~~~~~~~~~~~~~~~~~~~~~~~~~~
-------111
--11---111
--111--11-
----------
-11-------
11a-------
1111111111
11----1111
~~~~~~~~~~~~~~~~~~~~~~~~~~~~~~~~~~~~~
