~~~~~~~~~~~~~~~~~~~~~~~~~~~~~~~~~~~~~
1111-----1
--11---111
----------
----------
----------
---111----
--11111---
----------
~~~~~~~~~~~~~~~~~~~~~~~~~~~~~~~~~~~~~
11111---11
-------111
----------
----------
----------
---111----
--11111---
----------
~~~~~~~~~~~~~~~~~~~~~~~~~~~~~~~~~~~~~
1--111---1
--11---111
----------
----------
----------
---111----
--11111---
----------
~~~~~~~~~~~~~~~~~~~~~~~~~~~~~~~~~~~~~
11------11
-11-111---
----------
----------
----------
---111----
--11111---
----------
~~~~~~~~~~~~~~~~~~~~~~~~~~~~~~~~~~~~~
--1111-111
--1111-111
----------
11--------
111-----1a
11B111--11
1111111L--
11111--l--
~~~~~~~~~~~~~~~~~~~~~~~~~~~~~~~~~~~~~
----B111B1
a---11-111
111-------
11--------
--L111L---
--l---l---
--l---l---
--l---l---
~~~~~~~~~~~~~~~~~~~~~~~~~~~~~~~~~~~~~
11----1111
-------111
----------
----------
--1---1---
1-1SSS1--1
1111111--1
----------
~~~~~~~~~~~~~~~~~~~~~~~~~~~~~~~~~~~~~
11-----111
1111---111
----------
----------
----------
---111----
--11111---
----------
~~~~~~~~~~~~~~~~~~~~~~~~~~~~~~~~~~~~~
------1111
--1111-111
----------
---11----
---111--11
--A111a---
--11111111
----------
~~~~~~~~~~~~~~~~~~~~~~~~~~~~~~~~~~~~~
111111--11
----------
-------A11
-------111
11111-----
11111-----
----------
----------
~~~~~~~~~~~~~~~~~~~~~~~~~~~~~~~~~~~~~
